1 1
WWWWWW
WFGBFW
WFPFFW
WFFFFW
WWWWWW