2 3
WWWWWWWWWWW
WFFFFFWFGFW
WFGFFFWFBFW
WFBBFFWFFFW
WFFFFFFFFFW
WWWWWWWWWWW