2 2
WWWWWWWWWWW
WFFFFFFFFFW
WFFFFFFFBFW
WFBFFWWWFFW
WFFFFFGGFFW
WWWWWWWWWWW